border_size=1
usage=map

Xv          , Xv          , Xv          , Xv          , Xv          , Xv          , Xv          , Xv          , Xv          , Xv          , Xv          , Xv          , Xv          , Xv          , Xv          , Xv          , Xv          , Xv          , Xv          , Xv          , Xv          , Xv          , Xv          
Xv          , Xv          , Xv          , Xv          , Xv          , Xv          , Xv          , Xv          , Xv          , Xv          , Xv          , Xv          , Chw         , Chw         , Chw         , Xv          , Xv          , Xv          , Xv          , Xv          , Xv          , Xv          , Xv          
Xv          , Xv          , Xv          , Xv          , Xv          , Xv          , Chw         , Xv          , Xu          , Xu          , Wwf         , Xv          , Xv          , Khw         , Xv          , Xv          , Xv          , Xv          , Xv          , Xv          , Xv          , Xv          , Xv          
Xv          , Xv          , Xv          , Xv          , Xv          , Chw         , Khw         , Xv          , Xv          , 1 Chw       , Wwf         , Rr          , Xv          , Wwf         , Xv          , Xu          , Xu          , Xv          , Xv          , Xv          , Xv          , Xv          , Xv          
Xv          , Xv          , Xv          , Xv          , Xv          , Chw         , Xv          , Wwf         , Wwf         , Xv          , Xv          , Xv          , Wwf         , Wwf         , Xv          , 2 Chw       , Wwf         , Xv          , Xv          , Xv          , Xv          , Xv          , Xv          
Xv          , Xv          , Xv          , Xv          , Xv          , Xv          , Rr          , Xv          , Wwf         , Chw         , Khw         , Chw         , Wwf         , Chw         , Xv          , Wwf         , Rr          , Xv          , Chw         , Xv          , _off^_usr   , Xv          , Xv          
Xv          , Xv          , Xv          , Xv          , Xu          , Wwf         , Wwf         , Xv          , Chw         , Wwf         , Wwf         , Wwf         , Wwf         , Khw         , Chw         , Xv          , Xv          , Xv          , Khw         , Chw         , _off^_usr   , Xv          , Xv          
Xv          , Xv          , Xv          , Xv          , Xu          , 6 Chw       , Xv          , Xv          , Khw         , Wwf         , Wwf         , Wwf         , Wwf         , Wwf         , Wwf         , Wwf         , Wwf         , Wwf         , Xv          , Chw         , Xv          , Xv          , Xv          
Xv          , Xv          , Xv          , Xv          , Xv          , Xv          , Wwf         , Chw         , Wwf         , Wwf         , Wwf         , Chw         , Wwf         , Wwf         , Khw         , Chw         , Xv          , Xv          , Xu          , Xv          , Xv          , Xv          , Xv          
Xv          , Xv          , Xv          , Chw         , Khw         , Wwf         , Xv          , Wwf         , Chw         , Wwf         , Wwf         , Wwf         , Wwf         , Wwf         , Chw         , Xv          , Wwf         , 3 Chw       , Xu          , Xv          , Xv          , Xv          , Xv          
Xv          , Xv          , Xv          , Chw         , Chw         , Xv          , Rr          , Xv          , Xv          , Khw         , Wwf         , Wwf         , Khw         , Wwf         , Wwf         , Xv          , Rr          , Wwf         , Xv          , Xv          , Xv          , Xv          , Xv          
Xv          , Xv          , Xv          , Xv          , Xv          , Xv          , Wwf         , Wwf         , Xv          , Chw         , Wwf         , Chw         , Xv          , Chw         , Wwf         , Xv          , Xv          , Xv          , Xv          , Xv          , Xv          , Xv          , Xv          
Xv          , Xv          , Xv          , Xv          , Xv          , Xv          , Xu          , 5 Chw       , Xv          , Wwf         , Xv          , Xv          , Wwf         , Xv          , Xv          , Wwf         , Khw         , Chw         , _off^_usr   , Xv          , Xv          , Xv          , Xv          
Xv          , Xv          , Xv          , Xv          , Xv          , Xv          , Xv          , Xu          , Xv          , Wwf         , Xv          , Rr          , Wwf         , 4 Chw       , Xu          , Xv          , Chw         , Chw         , _off^_usr   , Xv          , Xv          , Xv          , Xv          
Xv          , Xv          , Xv          , Xv          , Xv          , Xv          , Xv          , Xv          , Chw         , Khw         , Chw         , Xv          , Xv          , Xu          , Xv          , Xv          , Xv          , _off^_usr   , Xv          , Xv          , Xv          , Xv          , Xv          
Xv          , Xv          , Xv          , Xv          , Xv          , Xv          , Xv          , Xv          , Xv          , Chw         , Xv          , Xv          , Xv          , Xv          , Xv          , Xv          , Xv          , Xv          , Xv          , Xv          , Xv          , Xv          , Xv          
Xv          , Xv          , Xv          , Xv          , Xv          , Xv          , Xv          , Xv          , Xv          , Xv          , Xv          , Xv          , Xv          , Xv          , Xv          , Xv          , Xv          , Xv          , Xv          , Xv          , Xv          , Xv          , Xv          
