border_size=1
usage=map

Xv          , Xv          , Xv          , Xv          , Xv          , Xv          , Xv          , Xv          , Xv          , Xv          , Xv          , Xv          , Xv          , Xv          , Xv          , Xv          , Xv          , Xv          , Xv          , Xv          , Xv          , Xv          , Xv          , Xv          , Xv          , Xv          , Xv          , Xv          , Xv          , Xv          , Xv          , Xv          , Xv          
Xv          , Xv          , Xv          , Xv          , Xv          , Xv          , Xv          , Xv          , Xv          , Xv          , Xv          , Xv          , Xv          , Xv          , Xv          , Xv          , Xv          , Xv          , Xv          , Xv          , Xv          , Xv          , Xv          , Xv          , Xv          , Xv          , Xv          , Xv          , Xv          , Xv          , Xv          , Xv          , Xv          
Xv          , Xv          , Xv          , Xv          , Xv          , Xv          , Xv          , Xv          , Xv          , Xv          , Xv          , Xv          , Xv          , Xv          , Chw         , Xu          , Chw         , Xu          , Chw         , Xv          , Xv          , Xv          , Xv          , Xv          , Xv          , Xv          , Xv          , Xv          , Xv          , Xv          , Xv          , Xv          , Xv          
Xv          , Xv          , Xv          , Xv          , Xv          , Xv          , Xv          , Xv          , Xv          , Xv          , Xv          , Xv          , Xv          , Xv          , Mm^Xm       , Xu          , Chw         , Xu          , Mm^Xm       , Xv          , Xv          , Xv          , Xv          , Xv          , Xv          , Xv          , Xv          , Xv          , Xv          , Xv          , Xv          , Xv          , Xv          
Xv          , Xv          , Xv          , Xv          , Xv          , Xv          , Xv          , Xv          , Xv          , Xv          , Xv          , Xv          , Mm^Xm       , Mm^Xm       , Chw         , Xu          , Chw         , Xu          , Chw         , Mm^Xm       , Mm^Xm       , Xv          , Xv          , Xv          , Xv          , Xv          , Xv          , Xv          , Xv          , Xv          , Xv          , Xv          , Xv          
Xv          , Xv          , Xv          , Xv          , Xv          , Xv          , Xv          , Xv          , Xv          , Xv          , Mm^Xm       , Mm^Xm       , Xv          , Xv          , Xv          , Xu          , Xv          , Xu          , Xv          , Xv          , Xv          , Mm^Xm       , Mm^Xm       , Xv          , Xv          , Xv          , Xv          , Xv          , Xv          , Xv          , Xv          , Xv          , Xv          
Xv          , Xv          , Xv          , Xv          , Xv          , Xv          , Xv          , Xv          , Mm^Xm       , Mm^Xm       , Xv          , Xv          , Xv          , Xv          , Xv          , Xv          , Xv          , Xv          , Xv          , Xv          , Xv          , Xv          , Xv          , Mm^Xm       , Mm^Xm       , Xv          , Xv          , Xv          , Xv          , Xv          , Xv          , Xv          , Xv          
Xv          , Xv          , Xv          , Xv          , Xv          , Xv          , Xv          , Xv          , Mm^Xm       , Xv          , Xv          , Xv          , Xv          , Xv          , Xv          , Xv          , Xv          , Xv          , Xv          , Xv          , Xv          , Xv          , Xv          , Xv          , Mm^Xm       , Xv          , Xv          , Xv          , Xv          , Xv          , Xv          , Xv          , Xv          
Xv          , Xv          , Xv          , Xv          , Xv          , Xv          , Chw         , Xu          , Chw         , Xu          , Chw         , Xv          , Xv          , Xv          , Xv          , Xv          , Xv          , Xv          , Xv          , Xv          , Xv          , Xv          , Chw         , Xu          , Chw         , Xu          , Chw         , Xv          , Xv          , Xv          , Xv          , Xv          , Xv          
Xv          , Xv          , Xv          , Xv          , Xv          , Xv          , Mm^Xm       , Xu          , Chw         , Xu          , Mm^Xm       , Xv          , Xv          , Xv          , Xv          , Xv          , Xv          , Xv          , Xv          , Xv          , Xv          , Xv          , Mm^Xm       , Xu          , Chw         , Xu          , Mm^Xm       , Xv          , Xv          , Xv          , Xv          , Xv          , Xv          
Xv          , Xv          , Xv          , Xv          , Mm^Xm       , Mm^Xm       , Chw         , Xu          , Chw         , Xu          , Chw         , Mm^Xm       , Mm^Xm       , Xv          , Xv          , Xv          , Xv          , Xv          , Xv          , Xv          , Mm^Xm       , Mm^Xm       , Chw         , Xu          , Chw         , Xu          , Chw         , Mm^Xm       , Mm^Xm       , Xv          , Xv          , Xv          , Xv          
Xv          , Xv          , Xv          , Xv          , Mm^Xm       , Xv          , Xv          , Xu          , Xv          , Xu          , Xv          , Xv          , Mm^Xm       , Xv          , Xv          , Xv          , Xv          , Xv          , Xv          , Xv          , Mm^Xm       , Xv          , Xv          , Xu          , Xv          , Xu          , Xv          , Xv          , Mm^Xm       , Xv          , Xv          , Xv          , Xv          
Xv          , Xv          , Xv          , Xv          , Mm^Xm       , Xv          , Xv          , Xv          , Xv          , Xv          , Xv          , Xv          , Mm^Xm       , Xv          , Xv          , Xv          , Xv          , Xv          , Xv          , Xv          , Mm^Xm       , Xv          , Xv          , Xv          , Xv          , Xv          , Xv          , Xv          , Mm^Xm       , Xv          , Xv          , Xv          , Xv          
Xv          , Xv          , Xv          , Xv          , Mm^Xm       , Xv          , Xv          , Xv          , Xv          , Xv          , Xv          , Xv          , Mm^Xm       , Xv          , Xv          , Xv          , Xv          , Xv          , Xv          , Xv          , Mm^Xm       , Xv          , Xv          , Xv          , Xv          , Xv          , Xv          , Xv          , Mm^Xm       , Xv          , Xv          , Xv          , Xv          
Xv          , Xv          , Chw         , Chw         , Xu          , Chw         , Chw         , Xv          , Xv          , Xv          , Chw         , Chw         , Xu          , Chw         , Chw         , Xv          , Xv          , Xv          , Chw         , Chw         , Xu          , Chw         , Chw         , Xv          , Xv          , Xv          , Chw         , Chw         , Xu          , Chw         , Chw         , Xv          , Xv          
Xv          , Xv          , Khw         , Chw         , Xu          , Chw         , Khw         , Xv          , Xv          , Xv          , Khw         , Chw         , Xu          , Chw         , Khw         , Xv          , Xv          , Xv          , Khw         , Chw         , Xu          , Chw         , Khw         , Xv          , Xv          , Xv          , Khw         , Chw         , Xu          , Chw         , Khw         , Xv          , Xv          
Xv          , Xv          , Chw         , Chw         , Xu          , Chw         , Chw         , Xv          , Xv          , Xv          , Chw         , Chw         , Xu          , Chw         , Chw         , Xv          , Xv          , Xv          , Chw         , Chw         , Xu          , Chw         , Chw         , Xv          , Xv          , Xv          , Chw         , Chw         , Xu          , Chw         , Chw         , Xv          , Xv          
Xv          , Xv          , Xv          , Chw         , Xv          , Chw         , Xv          , Xv          , Xv          , Xv          , Xv          , Chw         , Xv          , Chw         , Xv          , Xv          , Xv          , Xv          , Xv          , Chw         , Xv          , Chw         , Xv          , Xv          , Xv          , Xv          , Xv          , Chw         , Xv          , Chw         , Xv          , Xv          , Xv          
Xv          , Xv          , Xv          , Xv          , Xv          , Xv          , Xv          , Xv          , Xv          , Xv          , Xv          , Xv          , Xv          , Xv          , Xv          , Xv          , Xv          , Xv          , Xv          , Xv          , Xv          , Xv          , Xv          , Xv          , Xv          , Xv          , Xv          , Xv          , Xv          , Xv          , Xv          , Xv          , Xv          
Xv          , Xv          , Rr          , Xv          , Xv          , Xv          , Rr          , Xv          , Xv          , Xv          , Rr          , Xv          , Xv          , Xv          , Rr          , Xv          , Xv          , Xv          , Rr          , Xv          , Xv          , Xv          , Rr          , Xv          , Xv          , Xv          , Rr          , Xv          , Xv          , Xv          , Rr          , Xv          , Xv          
Xv          , Xv          , Wwf         , Wwf         , Xv          , Wwf         , Wwf         , Xv          , Xv          , Xv          , Wwf         , Wwf         , Xv          , Wwf         , Wwf         , Xv          , Xv          , Xv          , Wwf         , Wwf         , Xv          , Wwf         , Wwf         , Xv          , Xv          , Xv          , Wwf         , Wwf         , Xv          , Wwf         , Wwf         , Xv          , Xv          
Xv          , Xv          , Xv          , 1 Wwf       , Xv          , 2 Wwf       , Xv          , Xv          , Xv          , Xv          , Xv          , 3 Wwf       , Xv          , 4 Wwf       , Xv          , Xv          , Xv          , Xv          , Xv          , 5 Wwf       , Xv          , 6 Wwf       , Xv          , Xv          , Xv          , Xv          , Xv          , 7 Wwf       , Xv          , 8 Wwf       , Xv          , Xv          , Xv          
Xv          , Xv          , Xv          , Xv          , Xv          , Xv          , Xv          , Xv          , Xv          , Xv          , Xv          , Xv          , Xv          , Xv          , Xv          , Xv          , Xv          , Xv          , Xv          , Xv          , Xv          , Xv          , Xv          , Xv          , Xv          , Xv          , Xv          , Xv          , Xv          , Xv          , Xv          , Xv          , Xv          
Xv          , Xv          , Xv          , Xv          , Xv          , Xv          , Xv          , Xv          , Xv          , Xv          , Xv          , Xv          , Xv          , Xv          , Xv          , Xv          , Xv          , Xv          , Xv          , Xv          , Xv          , Xv          , Xv          , Xv          , Xv          , Xv          , Xv          , Xv          , Xv          , Xv          , Xv          , Xv          , Xv          
